Всего в Алгопаке доступны данные по 248 акциям Мосбиржи
Для 1 уровня листинга отобрано 66 акций:
AFKS - Система ао
AFLT - Аэрофлот
AGRO - AGRO-гдр
ALRS - АЛРОСА ао
AQUA - ИНАРКТИКА
BELU - НоваБев ао
BSPB - БСП ао
CBOM - МКБ ао
CHMF - СевСт-ао
CIAN - CIAN-адр
ELFV - ЭЛ5Энер ао
ENPG - ЭН+ГРУП ао
ETLN - ETLN-гдр
EUTR - ЕвроТранс
FEES - Россети
FIVE - FIVE-гдр
FIXP - FIXP-гдр
FLOT - Совкомфлот
GAZP - ГАЗПРОМ ао
GEMC - МКПАО ЮМГ
GLTR - GLTR-гдр
GMKN - ГМКНорНик
HHRU - iHHRU-адр
HYDR - РусГидро
IRAO - ИнтерРАОао
LENT - Лента ао
LKOH - ЛУКОЙЛ
LSRG - ЛСР ао
MAGN - ММК
MDMG - MDMG-гдр
MOEX - МосБиржа
MSNG - +МосЭнерго
MTLR - Мечел ао
MTLRP - Мечел ап
MTSS - МТС-ао
MVID - М.видео
NLMK - НЛМК ао
NVTK - Новатэк ао
OKEY - OKEY-гдр
OZON - OZON-адр
PHOR - ФосАгро ао
PIKK - ПИК ао
PLZL - Полюс
POSI - iПозитив
RENI - Ренессанс
RNFT - РуссНфт ао
ROSN - Роснефть
RTKM - Ростел -ао
RTKMP - Ростел -ап
RUAL - РУСАЛ ао
SBER - Сбербанк
SBERP - Сбербанк-п
SELG - Селигдар
SFIN - ЭсЭфАй ао
SGZH - Сегежа
SMLT - Самолет ао
SVCB - Совкомбанк
TATN - Татнфт 3ао
TATNP - Татнфт 3ап
TCSG - ТКСХолд ао
TGKA - ТГК-1
TRNFP - Транснф ап
UPRO - Юнипро ао
VKCO - МКПАО "ВК"
VTBR - ВТБ ао
YNDX - Yandex clA
______________________________________________________________________
Для 2 уровня листинга отобрано 27 акций:
ABIO - iАРТГЕН ао
AKRN - Акрон
APTK - Аптеки36и6
ASTR - Астра ао
DELI - Каршеринг
DIAS - Диасофт
FESH - ДВМП ао
HNFG - ХЭНДЕРСОН
KMAZ - КАМАЗ
MRKC - РоссЦентр
MRKP - РСетиЦП ао
MRKS - РсетСиб ао
MRKU - Россети Ур
MRKV - РсетВол ао
MRKZ - РСетиСЗ ао
MSRS - РСетиМР ао
OGKB - ОГК-2 ао
RASP - Распадская
SNGS - Сургнфгз
SNGSP - Сургнфгз-п
SOFL - iСофтлайн
SVAV - СОЛЛЕРС
TGKN - ТГК-14
TRMK - ТМК ао
UGLD - ЮГК
VSMO - ВСМПО-АВСМ
WUSH - iВУШХолднг
______________________________________________________________________
Для 3 уровня листинга отобрано 155 акций:
ABRD - АбрауДюрсо
ACKO - АСКО ао
AMEZ - АшинскийМЗ
ARSA - Арсагера
ASSB - АстрЭнСб
AVAN - Авангрд-ао
BANE - Башнефт ао
BANEP - Башнефт ап
BISVP - БашИнСв ап
BLNG - Белон ао
BRZL - БурЗолото
BSPBP - БСП ап
CARM - СТГ
CHGZ - РН-ЗапСиб
CHKZ - ЧКПЗ ао
CHMK - ЧМК ао
CNTL - Телеграф
CNTLP - Телеграф-п
DIOD - ЗаводДИОД
DSKY - ДетскийМир
DVEC - ДЭК ао
DZRD - ДонскЗР
DZRDP - ДонскЗР п
EELT - ЕвроЭлтех
GAZC - ГАЗКОН-ао
GAZS - ГАЗ-сервис
GAZT - ГАЗ-Тек ао
GCHE - ЧеркизГ-ао
GECO - iГЕНЕТИКО
GEMA - iММЦБ ао
GTRK - ГТМ ао
HIMCP - Химпром ап
IGST - Ижсталь2ао
IGSTP - Ижсталь ап
INGR - ИНГРАД ао
IRKT - Яковлев-3
JNOS - Славн-ЯНОС
JNOSP - Слав-ЯНОСп
KAZT - Куйбазот
KAZTP - Куйбазот-п
KBSB - ТНСэКубань
KCHE - КамчатЭ ао
KCHEP - КамчатЭ ап
KGKC - КурганГКао
KGKCP - КурганГКап
KLSB - КалужскСК
KLVZ - Кристалл
KMEZ - КМЗ
KOGK - КоршГОК ао
KRKN - СаратНПЗ
KRKNP - СаратНПЗ-п
KRKOP - ТКЗКК ап
KROT - КрасОкт-ао
KROTP - КрасОкт-1п
KRSB - Красэсб ао
KRSBP - Красэсб ап
KTSB - КСБ ао
KTSBP - КСБ ап
KUBE - РСетКубань
KUZB - КузнецкийБ
KZOS - ОргСинт ао
KZOSP - ОргСинт ап
LNZL - Лензолото
LNZLP - Лензол. ап
LSNG - РСетиЛЭ
LSNGP - РСетиЛЭ-п
LVHK - Левенгук
MAGE - МагадЭн ао
MAGEP - МагадЭн ап
MFGS - Мегион-ао
MFGSP - Мегион-ап
MGKL - МГКЛ
MGNT - Магнит ао
MGNZ - СМЗ-ао
MGTS - МГТС-5ао
MGTSP - МГТС-4ап
MISB - ТНСэнМарЭл
MISBP - ТНСэМаЭл-п
MRKK - Россети СК
MRKY - РоссЮг ао
MRSB - МордЭнСб
MSTT - Мостотрест
NAUK - iНПОНаука
NFAZ - НЕФАЗ
NKHP - НКХП ао
NKNC - НКНХ ао
NKNCP - НКНХ ап
NKSH - Нижкамшина
NMTP - НМТП ао
NNSB - ТНСэнНН ао
NNSBP - ТНСэнНН ап
NSVZ - iНаукаСвяз
OMZZP - ОМЗ-ап
PMSB - ПермьЭнСб
PMSBP - ПермьЭнС-п
POLY - Polymetal
PRFN - ЧЗПСН ао
PRMB - Приморье
QIWI - iQIWI
RBCM - ГК РБК ао
RDRB - РДБанк ао
RGSS - РГС СК ао
RKKE - ЭнергияРКК
ROLO - Русолово
ROSB - Росбанк ао
ROST - РОСИНТЕРао
RTGZ - ГазпРнД ао
RTSB - ТНСэнРст
RTSBP - ТНСэнРст-п
RUSI - ИКРУСС-ИНВ
RZSB - РязЭнСб
SAGO - СамарЭн-ао
SAGOP - СамарЭн-ап
SARE - СаратЭн-ао
SAREP - СаратЭн-ап
SIBN - Газпрнефть
SLEN - Сахэнер ао
SPBE - СПБ Биржа
STSB - СтаврЭнСб
STSBP - СтаврЭнСбп
SVET - Светофор
TASB - ТамбЭнСб
TASBP - ТамбЭнСб-п
TGKB - ТГК-2
TGKBP - ТГК-2 ап
TNSE - ТНСэнрг ао
TORS - ТРК ао
TORSP - ТРК ап
TTLK - Таттел. ао
TUZA - ТЗА ао
UKUZ - ЮжКузб. ао
UNAC - iАвиастКао
UNKL - ЮУНК ао
URKZ - УрКузница
USBN - УралСиб ао
UTAR - ЮТэйр ао
VEON-RX - VEON
VGSB - ВолгЭнСб
VGSBP - ВолгЭнСб-п
VJGZ - Варьеган
VJGZP - Варьеган-п
VLHZ - ВХЗ-ао
VRSB - ТНСэнВорон
VRSBP - ТНСэнВор-п
VSYD - ВыбСудЗ ао
VSYDP - ВыбСудЗ ап
WTCM - ЦМТ ао
WTCMP - ЦМТ ап
YAKG - ЯТЭК ао
YKEN - Якутскэнрг
YKENP - Якутскэн-п
YRSB - ТНСэнЯр
YRSBP - ТНСэнЯр-п
ZILL - ЗИЛ ао
ZVEZ - ЗВЕЗДА ао
______________________________________________________________________
